You wake up on the floor in an unfamilar place… Well, you think it is unfamiliar. You can't seem remember your name or how you got here, but frankly just thinking about it gives you a huge headache. You don't think you are injured, but you feel groggy. …Where are you?

Worlds Away - Inform7 Final Project
An Interactive Fiction by kmkim16
Release 1 / Serial number 140307 / Inform 7 build 6G60 (I6/v6.32 lib 6/12N) SD

White Room
A blank, white room with a large fan as a floor. A wind tunnel, perhaps? The fan circulates air upwards. Soshite, Roboto wa offu desuu.

>x
What do you want to examine?

>xdan
You can't see any such thing.

>x fan
A large fan blows, circulating the air. It seem to be a bit dusty, but other than that it's brand new.

On Fan is contraption.

* * *

You wake up on the floor in an unfamilar place… Well, you think it is unfamiliar. You can't seem remember your name or how you got here, but frankly just thinking about it gives you a huge headache. You don't think you are injured, but you feel groggy. …Where are you?

Worlds Away - Inform7 Final Project
An Interactive Fiction by kmkim16
Release 1 / Serial number 140307 / Inform 7 build 6G60 (I6/v6.32 lib 6/12N) SD

White Room
A blank, white room with a large fan as a floor. A wind tunnel, perhaps? The fan circulates air upwards. Soshite, Roboto wa offu desuu.

>look room
You can't see any such thing.

>look fan
A large fan blows, circulating the air. It seem to be a bit dusty, but other than that it's brand new.

On Fan is contraption.

>look contraption
portal gun yo

>eat portal gun
(first taking contraption)
The blade spins by nearly cutting your hand off. jesus. You can't reach the contraption. Maybe you can stop the fan with something

>tug
That's not a verb I recognise.

>take portal gun
You're kind of bleeding now...

    *** You have died ***

Would you like to RESTART, RESTORE a saved game, QUIT or UNDO the last command?

>undo
White Room
[Previous turn undone.]

>look robot
（。-＿-。）.

Robot is currently switched off.

>turn on robot
bEEP BOOP. BOOP BEE BOOP. I AM ON, WOOHOO!.

>tickle robot
That's not a verb I recognise.

>use robot
That's not a verb I recognise.

>take robot
Taken.

>take portal gun
you;re not bleeding yay! and you have a portal gun. nice.

>shoot robot
That's not a verb I recognise.

>shoot gun
That's not a verb I recognise.

>die
That's not a verb I recognise.

>:(
That's not a verb I recognise.

>:(
That's not a verb I recognise.

>: (
That's not a verb I recognise.

I beg your pardon?

>poop
That's not a verb I recognise.

>turn robot off
That's already off.

>turn robot on
bEEP BOOP. BOOP BEE BOOP. I AM ON, WOOHOO!.

>kill robot
Violence isn't the answer to this one.

>shoot window
That's not a verb I recognise.

>use portal gun
That's not a verb I recognise.

>kill self
Violence isn't the answer to this one.

* * *

You wake up on the floor in an unfamilar place… Well, you think it is unfamiliar. You can't seem remember your name or how you got here, but frankly just thinking about it gives you a huge headache. You don't think you are injured, but you feel groggy. …Where are you?

Worlds Away - Inform7 Final Project
An Interactive Fiction by kmkim16
Release 1 / Serial number 140307 / Inform 7 build 6G60 (I6/v6.32 lib 6/12N) SD

White Room
A blank, white room with a large fan as a floor. A wind tunnel, perhaps? The fan circulates air upwards. Soshite, Roboto wa offu desuu.

>take box
Taken.

* * *

You wake up on the floor in an unfamilar place… Well, you think it is unfamiliar. You can't seem remember your name or how you got here, but frankly just thinking about it gives you a huge headache. You don't think you are injured, but you feel groggy. …Where are you?

Worlds Away - Inform7 Final Project
An Interactive Fiction by kmkim16
Release 1 / Serial number 140307 / Inform 7 build 6G60 (I6/v6.32 lib 6/12N) SD

White Room
A blank, white room with a large fan as a floor. A wind tunnel, perhaps? The fan circulates air upwards. Soshite, Roboto wa offu desuu.

>turn on robot
bEEP BOOP. BOOP BEE BOOP. I AM ON, WOOHOO!.

>x
What do you want to examine?

>x robot
(*ﾟｰﾟ)ゞ

Robot is currently switched off.

>take all
Fan: you can't take the floor sillyRobot: Taken.
contraption: The blade spins by nearly cutting your hand off. jesus. You can't reach the contraption. Maybe you can stop the fan with something instead?

>i
You are carrying:
  Robot

* * *

You wake up on the floor in an unfamilar place… Well, you think it is unfamiliar. You can't seem remember your name or how you got here, but frankly just thinking about it gives you a huge headache. You don't think you are injured, but you feel groggy. …Where are you?

Worlds Away - Inform7 Final Project
An Interactive Fiction by kmkim16
Release 1 / Serial number 140307 / Inform 7 build 6G60 (I6/v6.32 lib 6/12N) SD

White Room
A blank, white room with a large fan as a floor. A wind tunnel, perhaps? The fan circulates air upwards. Soshite, Roboto wa offu desuu.

>x me
you are a person

* * *

You wake up on the floor in an unfamilar place… Well, you think it is unfamiliar. You can't seem remember your name or how you got here, but frankly just thinking about it gives you a huge headache. You don't think you are injured, but you feel groggy. …Where are you?

Worlds Away - Inform7 Final Project
An Interactive Fiction by kmkim16
Release 1 / Serial number 140307 / Inform 7 build 6G60 (I6/v6.32 lib 6/12N) SD

White Room
A blank, white room with a large fan as a floor. A wind tunnel, perhaps? The fan circulates air upwards. Soshite, Roboto wa offu desuu.

>open container
You can't see any such thing.

>open box
That's not something you can open.

* * *

You wake up on the floor in an unfamilar place… Well, you think it is unfamiliar. You can't seem remember your name or how you got here, but frankly just thinking about it gives you a huge headache. You don't think you are injured, but you feel groggy. …Where are you?

Worlds Away - Inform7 Final Project
An Interactive Fiction by kmkim16
Release 1 / Serial number 140307 / Inform 7 build 6G60 (I6/v6.32 lib 6/12N) SD

White Room
A blank, white room with a large fan as a floor. A wind tunnel, perhaps? The fan circulates air upwards. Soshite, Roboto wa offu desuu.

>take contraption
The blade spins by nearly cutting your hand off. jesus. You can't reach the contraption. Maybe you can stop the fan with something

>i
You are carrying nothing.

>take robot
Taken.

>take contraption
Taken.

* * *

>take contraption
The blade spins by nearly cutting your hand off. jesus. You can't reach the contraption. Maybe you can stop the fan with something

>take robot
Taken.

>put robot in fan
You put Robot into Fan.

what

* * *

You wake up on the floor in an unfamilar place… Well, you think it is unfamiliar. You can't seem remember your name or how you got here, but frankly just thinking about it gives you a huge headache. You don't think you are injured, but you feel groggy. …Where are you?

Worlds Away - Inform7 Final Project
An Interactive Fiction by kmkim16
Release 1 / Serial number 140307 / Inform 7 build 6G60 (I6/v6.32 lib 6/12N) SD

White Room
A blank, white room with a large fan as a floor. A wind tunnel, perhaps? The fan circulates air upwards. Soshite, Roboto wa offu desuu.

>take robot
Taken.

* * *

>put robot in fan
You put Robot into Fan.

>take contraption
Taken.

* * *

>put robot in fan
You put Robot into Fan.

>put robot on fan
robot is in fan

* * *

>put robot in fan
You put Robot into Fan.

>take gun
Taken.

>shoot wall with gun
I only understood you as far as wanting to shoot Wall.

>x portal
You can't see any such thing.

>shoot
(contraption)
u suck

>shoot wall
wow u did a thing

>shooting
That's not a verb I recognise.

>shot wall
That's not a verb I recognise.

>shoot wll
You can't see any such thing.

>shoot wall
wow u did a thing

>shoot wall with gun
I only understood you as far as wanting to shoot Wall.

>shoot wall
wow u did a thing

>shooting wall
That's not a verb I recognise.

>x portal
Portal is empty.

>enter portal
wooshoshoshoshoshooooo
Saloon

>get in portal
You can't see any such thing.

>back
That's not a verb I recognise.

>noooo
That's not a verb I recognise.

* * *

>shoot wall with gun
I only understood you as far as wanting to shoot Wall.

>enter portal
You can't see any such thing.

>touch portal
You can't see any such thing.

>x portal
You can't see any such thing.

>:,(
You seem to want to talk to someone, but I can't see whom.

* * *

>take robot
Taken.

>take contraption
The blade spins by nearly cutting your hand off. jesus. You can't reach the contraption. Maybe you can stop the fan with something instead?

>put robot in fan
You put Robot into Fan.

>take contraption
you;re not bleeding yay! and you have a portal gun. nice.

>shoot portal gun
the frick u doin bub

>shoot portal gun at wall
I only understood you as far as wanting to shoot contraption.

>shoot wall with portal gun
I only understood you as far as wanting to shoot Wall.

>shoot wall with contraption
I only understood you as far as wanting to shoot Wall.

* * *

>take robot
Taken.

>put robot on fan
robot on fan

>i
You are carrying:
  Robot

* * *

>take robot
Taken.

>shoot robot
That's not a verb I recognise.

* * *

>drop robot
Dropped.

>x fan
A large fan blows, circulating the air. It seem to be a bit dusty, but other than that it's brand new.

On Fan is contraption.

>take contraption
Taken.

* * *

You wake up on the floor in an unfamilar place… Well, you think it is unfamiliar. You can't seem remember your name or how you got here, but frankly just thinking about it gives you a huge headache. You don't think you are injured, but you feel groggy. …Where are you?

Worlds Away - Inform7 Final Project
An Interactive Fiction by kmkim16
Release 1 / Serial number 140307 / Inform 7 build 6G60 (I6/v6.32 lib 6/12N) SD

White Room
A blank, white room with a large fan as a floor. A wind tunnel, perhaps? The fan circulates air upwards. Soshite, Roboto wa offu desuu.

>x robot
（。-＿-。）.

Robot is currently switched off.

>take robot
Taken.

>take gun
The blade spins by nearly cutting your hand off. jesus. You can't reach the contraption. Maybe you can stop the fan with something instead?

>stop fan with robot
That's not a verb I recognise.

>:<
That's not a verb I recognise.

>take robot
You already have that.

>take gun
You're kind of bleeding now...

    *** You have died ***

Would you like to RESTART, RESTORE a saved game, QUIT or UNDO the last command?

* * *

>x robot
（。-＿-。）.

Robot is currently switched off.

>turn robot on
bEEP BOOP. BOOP BEE BOOP. I AM ON, WOOHOO!.

>x robot
(*ﾟｰﾟ)ゞ

Robot is currently switched off.

* * *

You wake up on the floor in an unfamilar place… Well, you think it is unfamiliar. You can't seem remember your name or how you got here, but frankly just thinking about it gives you a huge headache. You don't think you are injured, but you feel groggy. …Where are you?

Worlds Away - Inform7 Final Project
An Interactive Fiction by kmkim16
Release 1 / Serial number 140307 / Inform 7 build 6G60 (I6/v6.32 lib 6/12N) SD

White Room
A blank, white room with a large fan as a floor. A wind tunnel, perhaps? The fan circulates air upwards. Soshite, Roboto wa offu desuu.

>x fan
A large fan blows, circulating the air. It seem to be a bit dusty, but other than that it's brand new.

In Fan is contraption.

>take robot
Taken.

>take contraption
The blade spins by nearly cutting your hand off. jesus. You can't reach the contraption. Maybe you can stop the fan with something

>put robot in fan
You put Robot into Fan.

the fan stops

>take contraption
you;re not bleeding yay! and you have a portal gun. nice.

the fan stops

* * *

You wake up on the floor in an unfamilar place… Well, you think it is unfamiliar. You can't seem remember your name or how you got here, but frankly just thinking about it gives you a huge headache. You don't think you are injured, but you feel groggy. …Where are you?

Worlds Away - Inform7 Final Project
An Interactive Fiction by kmkim16
Release 1 / Serial number 140307 / Inform 7 build 6G60 (I6/v6.32 lib 6/12N) SD

White Room
A blank, white room with a large fan as a floor. A wind tunnel, perhaps? The fan circulates air upwards. Soshite, Roboto wa offu desuu.

>take fan
That's hardly portable.