You wake up on the floor in an unfamiliar place… Well, you think it is unfamiliar. You can't seem remember how you got here, but frankly just thinking about it gives you a huge headache. You don't think you are injured, but you feel groggy. …Where are you?u 

Worlds Away - Inform7 Final Project
An Interactive Fiction by kmkim16
Release 1 / Serial number 140311 / Inform 7 build 6G60 (I6/v6.32 lib 6/12N) SD

White Room
A blank, white room with a large fan as a floor. A wind tunnel, perhaps? The fan circulates air upwards. Something glints beneath the whirling blades. Also, you can see your little robot buddy here. You made it yourself!

>turn robot on
You hear a quiet hum as the robot powers on, followed by some quiet clicks, and the display on the screen changes to show a cute (*ﾟｰﾟ)ゞ .

The robotbeeps quietly to itself, and looks around the room.

>take robot
Taken.

>put robot in fan
You put Robot into Fan.

The robot beeps angrily at you.

>take contraption
You manage to safely retrieve your contraption. Upon closer inspection you note it looks rather similar to a gun. What did this do again?

Taken.

>drop shell
Dropped.

>i
You are carrying:
  contraption

>drop contraption
Dropped.

>take robot
Taken.

>take shell
Taken.

>take contraption
You're kind of bleeding now...

    *** You have died ***

Would you like to RESTART, RESTORE a saved game, QUIT or UNDO the last command?

* * *

>i
You are carrying:
  Shell
  parachute pack
  teleport
  bottle

>take robot
Taken.

>wear teleport
Work Shop
Ah, yeah. Your workshop. The large table is covered in metal shavings and large chunks of materials. On the left wall is a large metal panel labeled "CIRCUIT BOARD" in big red letters, and "danger" in small green ones below that. You may or may not have messed up on labeling it.

>put robot on circuit board
it agrees to be plugged into the circuit board. You hook the robot up to the panel and set it down in the indentation. The robot points to "White Room Fan" and you plug the wires in. A loud woosh sound. The robot's display goes dark as the power is sucked from its batteries into the fan's power source. A loud crash sound. You think the top blew off. time to go.

>wear bottle
White Room
A blank, white room with a large fan as a floor.  The fan circulates at an incredible speed, so fast that the roof has been blown right off.Something glints beneath the whirling blades. Also, you can see your little robot buddy here. You made it yourself!

    *** woooosh you get blown away and die. ***

Would you like to RESTART, RESTORE a saved game, QUIT or UNDO the last command?

>undo
Work Shop
[Previous turn undone.]

>wear parachute
You can't wear that!

* * *

>wear teleport
Work Shop
Ah, yeah. Your workshop. The large table is covered in metal shavings and large chunks of materials. On the left wall is a large metal panel labeled "CIRCUIT BOARD" in big red letters, and "danger" in small green ones below that. You may or may not have messed up on labeling it.

I beg your pardon?

* * *

>wear teleport
Work Shop
Ah, yeah. Your workshop. The large table is covered in metal shavings and large chunks of materials. On the left wall is a large metal panel labeled "CIRCUIT BOARD" in big red letters, and "danger" in small green ones below that. You may or may not have messed up on labeling it.

>x Circuit Board
There's a panel covering the circuit board. You'd have to open the panel to interact with the switches.

>put robot in circuit board
You can't see any such thing.

>take Circuit Board
That's fixed in place.

>i
You are carrying:
  Shell
  teleport

* * *

>wear teleport
Work Shop
Ah, yeah. Your workshop. The large table is covered in metal shavings and large chunks of materials. On the left wall is a large metal panel labeled "CIRCUIT BOARD" in big red letters, and "danger" in small green ones below that. You may or may not have messed up on labeling it.

>put robot on circuit board
You can't see any such thing.

>put robot on Circuit Board
You can't see any such thing.

>x Circuit Board
There's a panel covering the circuit board. You'd have to open the panel to interact with the switches.

* * *

>wear teleport
Work Shop
Ah, yeah. Your workshop. The large table is covered in metal shavings and large chunks of materials. On the left wall is a large metal panel labeled "CIRCUIT BOARD" in big red letters, and "danger" in small green ones below that. You may or may not have messed up on labeling it.

>put robot in circuit board
You can't see any such thing.

* * *

>take robot
Taken.

>turn robot on
You hear a quiet hum as the robot powers on, followed by some quiet clicks, and the display on the screen changes to show a cute (*ﾟｰﾟ)ゞ .

>put robot in fan
You put Robot into Fan.

The robot beeps angrily at you.

* * *

>take contraption
You manage to safely retrieve your contraption. Upon closer inspection you note it looks rather similar to a gun. What did this do again?

Taken.

>take robot
Taken.

The robot pokes sadly at the dents in its metal frame from the fan incident. the display changes to "( ≧Д≦)" and it rushes over you, quickly shoving its arm into your pocket and taking a random item from you in a fit of frustration and grumpiness.
nothing was taken

* * *

>take contraption
You manage to safely retrieve your contraption. Upon closer inspection you note it looks rather similar to a gun. What did this do again?

Taken.

>i
You are carrying:
  contraption
  Shell

>drop shell
Dropped.

>take shell
Taken.

>take robot
Taken.

The robot pokes sadly at the dents in its metal frame from the fan incident. the display changes to "( ≧Д≦)" and it rushes over you, quickly shoving its arm into your pocket and taking a random item from you in a fit of frustration and grumpiness.
The contraption was taken

>i
You are carrying:
  Robot
  Shell

* * *

>wear teleport
Work Shop
Ah, yeah. Your workshop. The large table is covered in metal shavings and large chunks of materials. On the left wall is a large metal panel labeled "CIRCUIT BOARD" in big red letters, and "danger" in small green ones below that. You may or may not have messed up on labeling it.

>put robot on Circuit Board
it agrees to be plugged into the circuit board. You hook the robot up to the panel and set it down in the indentation. The robot points to "White Room Fan" and you plug the wires in. A loud woosh sound. The robot's display goes dark as the power is sucked from its batteries into the fan's power source. A loud crash sound. You think the top blew off. time to go.

* * *

>wear teleport
Work Shop
Ah, yeah. Your workshop. The large table is covered in metal shavings and large chunks of materials. On the left wall is a large metal panel labeled "CIRCUIT BOARD" in big red letters, and "danger" in small green ones below that. You may or may not have messed up on labeling it.

>put robot in Circuit Board
That can't contain things.

>put robot on Circuit Board
BMO is all like naw frick dat noise and refuses to be plugged into the circuit board.

* * *

>put robot on circuit board
it agrees to be plugged into the circuit board. You hook the robot up to the panel and set it down in the indentation. The robot points to "White Room Fan" and you plug the wires in. A loud woosh sound. The robot's display goes dark as the power is sucked from its batteries into the fan's power source. A loud crash sound. You think the top blew off. time to go.

>wear parachute
You put on parachute pack.

>wear bottle
White Room
A blank, white room with a large fan as a floor.  The fan circulates at an incredible speed, so fast that the roof has been blown right off.Something glints beneath the whirling blades. Also, you can see your little robot buddy here. You made it yourself!

    *** wow what a cool kid!!! ***

Would you like to RESTART, RESTORE a saved game, QUIT or UNDO the last command?

* * *

>take robot
Taken.

>stop fan with robot
That's not a verb I recognise.

>use robot to stop fan
That's not a verb I recognise.

* * *

>take robot
Taken.

>put robot in dan
You can't see any such thing.

>put robot in fan
You put Robot into Fan.

>take contraption
You manage to safely retrieve your contraption. Upon closer inspection you note it looks rather similar to a gun. What did this do again?

Taken.

>shoot wall
You stick up your thumb and point your index finger at your target. "Pew!" you say under your breath as you flick your wrist, pretending to shoot. Unfortunately you aren't shooting WITH something, so your hand and imagination will do.

>enter portal
You can't see any such thing.

>shoot wall with gun
With a crackle and pop, a portal splits into the wall, creating a doorway to a new room. You wonder where it leads...

>enter
You can't bear to leave your cute robot friend behind. Maybe turn it on so it can follow you, or pick it up and take it with you?

>portal
That's not a verb I recognise.

>take robot
Taken.

>enter portal
You step through the portal into a new room.

Classroom
It's a traditional classroom, with chalkboards and rusty desks and everything. On the board is a faded diagram of the wind tunnel.

You can see Desks (in which is Papers) here.

>take blankets
You can't see any such thing.

>shoot wall with gun
With a crackle and pop, a portal splits into the wall, creating a doorway to a new room. You wonder where it leads...

>go through portal
You step through the portal into a new room.

Classroom
It's a traditional classroom, with chalkboards and rusty desks and everything. On the board is a faded diagram of the wind tunnel.

You can see Portal (empty) and Desks (in which is Papers) here.

>put robot in circuit board
You can't see any such thing.

>open circuit board
You can't see any such thing.

* * *

>take robot
Taken.

>put robot in fan
You put Robot into Fan.

>i
You are carrying nothing.

>take contraption
woo hoo you took the gun and still have your hand
You already have that.

* * *

>put robot in fan
You put Robot into Fan.

>get contraption
You manage to safely retrieve your contraption. Upon closer inspection you note it looks rather similar to a gun. What did this do again?

Taken.

>put robot in fan
(first taking Robot)

You put Robot into Fan.

>shoot wall with contraption
With a crackle and pop, a portal splits into the wall, creating a doorway to a new room. You wonder where it leads...

>go through portal
You can't bear to leave your cute robot friend behind. Maybe turn it on so it can follow you, or pick it up and take it with you?

>take robot
Taken.

* * *

>put robot in fan
(first taking Robot)

You put Robot into Fan.

>take contraption
You manage to safely retrieve your contraption. Upon closer inspection you note it looks rather similar to a gun. What did this do again?

Taken.

* * *

>shoot wall
You stick up your thumb and point your index finger at your target. "Pew!" you say under your breath as you flick your wrist, pretending to shoot. Unfortunately you aren't shooting WITH something, so your hand and imagination will do.

>shoot wall with contraption
With a crackle and pop, a portal splits into the wall, creating a doorway to a new room. You wonder where it leads...

* * *

>go through portal
You can't bear to leave your cute robot friend behind. Maybe turn it on so it can follow you, or pick it up and take it with you?

>turn on robot
The metal creaks and bends under the pressure of the blades pressing against it. Turning it on right now doesn't seem like a good idea.

>take robot
Taken.

* * *

>l
White Room
A blank, white room with a large fan as a floor. A wind tunnel, perhaps? The fan circulates air upwards. 

You can see Portal (empty) here.

* * *

>put robot in fan
(first taking Robot)

You put Robot into Fan.

>take gun
You manage to safely retrieve your contraption. Upon closer inspection you note it looks rather similar to a gun. What did this do again?

Taken.

>take robot
Taken.

>drop robot
Dropped.

>shoot wall with gun
With a crackle and pop, a portal splits into the wall, creating a doorway to a new room. You wonder where it leads...
You can't even begin to fathom how you would "shoot" with an object like that!

* * *

>take robot
Taken.

>ask for contraption back
You can't see any such thing.

>take contraption
You can't see any such thing.

>x robot
（。-＿-。） OFF.

Robot is currently switched off.