You wake up on the floor in an unfamilar place… Well, you think it is unfamiliar. You can't seem remember your name or how you got here, but frankly just thinking about it gives you a huge headache. You don't think you are injured, but you feel groggy. …Where are you?

Worlds Away - Inform7 Final Project
An Interactive Fiction by kmkim16
Release 1 / Serial number 140303 / Inform 7 build 6G60 (I6/v6.32 lib 6/12N) SD

White Room
A white room with no doors and . A large fan gently A wind tunnel, perhaps? Soshite, Roboto wa offu desuu.

>x
What do you want to examine?

>x robot
^_^

* * *

You wake up on the floor in an unfamilar place… Well, you think it is unfamiliar. You can't seem remember your name or how you got here, but frankly just thinking about it gives you a huge headache. You don't think you are injured, but you feel groggy. …Where are you?

Worlds Away - Inform7 Final Project
An Interactive Fiction by kmkim16
Release 1 / Serial number 140303 / Inform 7 build 6G60 (I6/v6.32 lib 6/12N) SD

White Room
A white room with no doors and . A large fan gently A wind tunnel, perhaps? Soshite, Roboto wa offu desuu.

>take box
Taken.

* * *

You wake up on the floor in an unfamilar place… Well, you think it is unfamiliar. You can't seem remember your name or how you got here, but frankly just thinking about it gives you a huge headache. You don't think you are injured, but you feel groggy. …Where are you?

Worlds Away - Inform7 Final Project
An Interactive Fiction by kmkim16
Release 1 / Serial number 140303 / Inform 7 build 6G60 (I6/v6.32 lib 6/12N) SD

White Room
A white room with no doors and . A large fan gently A wind tunnel, perhaps? Soshite, Roboto wa offu desuu.

>open fan
wow desu

* * *

You wake up on the floor in an unfamilar place… Well, you think it is unfamiliar. You can't seem remember your name or how you got here, but frankly just thinking about it gives you a huge headache. You don't think you are injured, but you feel groggy. …Where are you?

Worlds Away - Inform7 Final Project
An Interactive Fiction by kmkim16
Release 1 / Serial number 140303 / Inform 7 build 6G60 (I6/v6.32 lib 6/12N) SD

White Room
A white room with no doors and . A large fan gently A wind tunnel, perhaps? Soshite, Roboto wa offu desuu.

>z
Time passes.

>z
Time passes.

* * *

You wake up on the floor in an unfamilar place… Well, you think it is unfamiliar. You can't seem remember your name or how you got here, but frankly just thinking about it gives you a huge headache. You don't think you are injured, but you feel groggy. …Where are you?

Worlds Away - Inform7 Final Project
An Interactive Fiction by kmkim16
Release 1 / Serial number 140303 / Inform 7 build 6G60 (I6/v6.32 lib 6/12N) SD

White Room
A white room with no doors and . A large fan gently A wind tunnel, perhaps? Soshite, Roboto wa offu desuu.

>take robot
Taken.

* * *

You wake up on the floor in an unfamilar place… Well, you think it is unfamiliar. You can't seem remember your name or how you got here, but frankly just thinking about it gives you a huge headache. You don't think you are injured, but you feel groggy. …Where are you?

Worlds Away - Inform7 Final Project
An Interactive Fiction by kmkim16
Release 1 / Serial number 140303 / Inform 7 build 6G60 (I6/v6.32 lib 6/12N) SD

White Room
A white room with no doors and . A large fan gently A wind tunnel, perhaps? Soshite, Roboto wa offu desuu.

>take contraption
You can't reach from down here.

>i
You are carrying nothing.

* * *

You wake up on the floor in an unfamilar place… Well, you think it is unfamiliar. You can't seem remember your name or how you got here, but frankly just thinking about it gives you a huge headache. You don't think you are injured, but you feel groggy. …Where are you?

Worlds Away - Inform7 Final Project
An Interactive Fiction by kmkim16
Release 1 / Serial number 140303 / Inform 7 build 6G60 (I6/v6.32 lib 6/12N) SD

White Room
A white room with no doors and . A large fan gently A wind tunnel, perhaps? Soshite, Roboto wa offu desuu.

>open container
You can't see any such thing.

* * *

You wake up on the floor in an unfamilar place… Well, you think it is unfamiliar. You can't seem remember your name or how you got here, but frankly just thinking about it gives you a huge headache. You don't think you are injured, but you feel groggy. …Where are you?

Worlds Away - Inform7 Final Project
An Interactive Fiction by kmkim16
Release 1 / Serial number 140303 / Inform 7 build 6G60 (I6/v6.32 lib 6/12N) SD

White Room
A white room with no doors and . A large fan gently A wind tunnel, perhaps? Soshite, Roboto wa offu desuu.

>x fan
A large fan blows, circulating the air. It seem to be a bit dusty, but other than that it's brand new.

On Fan is contraption.

>x contraption
portal gun yo

>take fan
That's fixed in place.

* * *

>x contraption
portal gun yo

>take contraption
Taken.

* * *

>x contraption
portal gun yo

>take portal gun
You can't see any such thing.

* * *

>x fan
A large fan blows, circulating the air. It seem to be a bit dusty, but other than that it's brand new.

On Fan is contraption.

>take contraption
The blade spins by nearly cutting your hand off. jesus. You REALLY can't reach the contraption. Maybe you can stop the fan with something

>x contraption
examine contraption

* * *

>take contraption
The blade spins by nearly cutting your hand off. jesus. You REALLY can't reach the contraption. Maybe you can stop the fan with something

>take contraption
jkfjkghndfgkjnh

    *** You have died ***

Would you like to RESTART, RESTORE a saved game, QUIT or UNDO the last command?

* * *

>take contraption
The blade spins by nearly cutting your hand off. jesus. You REALLY can't reach the contraption. Maybe you can stop the fan with something

>take robot
Taken.

* * *

You wake up on the floor in an unfamilar place… Well, you think it is unfamiliar. You can't seem remember your name or how you got here, but frankly just thinking about it gives you a huge headache. You don't think you are injured, but you feel groggy. …Where are you?

Worlds Away - Inform7 Final Project
An Interactive Fiction by kmkim16
Release 1 / Serial number 140303 / Inform 7 build 6G60 (I6/v6.32 lib 6/12N) SD

White Room
A white room with no doors and . A large fan gently A wind tunnel, perhaps? Soshite, Roboto wa offu desuu.

>x contraption
afdsf

>take contraption
Taken.

* * *

You wake up on the floor in an unfamilar place… Well, you think it is unfamiliar. You can't seem remember your name or how you got here, but frankly just thinking about it gives you a huge headache. You don't think you are injured, but you feel groggy. …Where are you?

Worlds Away - Inform7 Final Project
An Interactive Fiction by kmkim16
Release 1 / Serial number 140303 / Inform 7 build 6G60 (I6/v6.32 lib 6/12N) SD

White Room
A white room with no doors and . A large fan gently A wind tunnel, perhaps? Soshite, Roboto wa offu desuu.

>take fan
That's hardly portable.

>shit
Real adventurers do not use such language.

>fuck
Real adventurers do not use such language.

>:o
That's not a verb I recognise.

>:,(
You seem to want to talk to someone, but I can't see whom.

>sleep
You aren't feeling especially drowsy.

>why noootttt
That's not a verb I recognise.

I beg your pardon?

>yeah you better beg for my pardon
That's not a verb I recognise.