Your name is Dirk Strider. You just woke up from a nice nap. You find yourself inside of your single room abode. It's nice. But small. Things, contraptions, inventions of yours are cluttered around the place.

Worlds Away - Inform7 Final Project
An Interactive Fiction by kmkim16
Release 1 / Serial number 140221 / Inform 7 build 6G60 (I6/v6.32 lib 6/12N) SD

White Room
You wake up in an empty, white room with no doors. A large fan A wind tunnel, perhaps? Soshite, Roboto wa offu desuu.

>take fan
That's hardly portable.

* * *

Your name is Dirk Strider. You just woke up from a nice nap. You find yourself inside of your single room abode. It's nice. But small. Things, contraptions, inventions of yours are cluttered around the place.

Worlds Away - Inform7 Final Project
An Interactive Fiction by kmkim16
Release 1 / Serial number 140221 / Inform 7 build 6G60 (I6/v6.32 lib 6/12N) SD

White Room
You wake up in an empty, white room with no doors. A large fan A wind tunnel, perhaps? Soshite, Roboto wa offu desuu.

>x robot
（。-＿-。）.

Robot is currently switched off.

>turn robot on
bEEP BOOP. BOOP BEE BOOP. I AM ON, BEECHU.

>x robot
(*ﾟｰﾟ)ゞ

Robot is currently switched off.

* * *

>x robot
（。-＿-。）.

Robot is currently switched off.

>turn on robot
He's not something you can switch.

* * *

Your name is Dirk Strider. You just woke up from a nice nap. You find yourself inside of your single room abode. It's nice. But small. Things, contraptions, inventions of yours are cluttered around the place.

Worlds Away - Inform7 Final Project
An Interactive Fiction by kmkim16
Release 1 / Serial number 140221 / Inform 7 build 6G60 (I6/v6.32 lib 6/12N) SD

White Room
You wake up in an empty, white room with no doors. A large fan A wind tunnel, perhaps? Soshite, Roboto wa offu desuu.

>x contraption
bloop contraption portal-y thing whoop.

* * *

Your name is Dirk Strider. You just woke up from a nice nap. You find yourself inside of your single room abode. It's nice. But small. Things, contraptions, inventions of yours are cluttered around the place.

Worlds Away - Inform7 Final Project
An Interactive Fiction by kmkim16
Release 1 / Serial number 140221 / Inform 7 build 6G60 (I6/v6.32 lib 6/12N) SD

White Room
You wake up in an empty, white room with no doors. A large fan A wind tunnel, perhaps? Soshite, Roboto wa offu desuu.

>x thingy
A portal gun? pew pew

>take portal gun
You can't see any such thing.

* * *

Your name is Dirk Strider. You just woke up from a nice nap. You find yourself inside of your single room abode. It's nice. But small. Things, contraptions, inventions of yours are cluttered around the place.

Worlds Away - Inform7 Final Project
An Interactive Fiction by kmkim16
Release 1 / Serial number 140221 / Inform 7 build 6G60 (I6/v6.32 lib 6/12N) SD

White Room
You wake up in an empty, white room with no doors. A large fan A wind tunnel, perhaps? Soshite, Roboto wa offu desuu.

>x blowtorch
A portal gun? pew pew

* * *

Your name is Dirk Strider. You just woke up from a nice nap. You find yourself inside of your single room abode. It's nice. But small. Things, contraptions, inventions of yours are cluttered around the place.

Worlds Away - Inform7 Final Project
An Interactive Fiction by kmkim16
Release 1 / Serial number 140221 / Inform 7 build 6G60 (I6/v6.32 lib 6/12N) SD

White Room
You wake up in an empty, white room with no doors. A large fan A wind tunnel, perhaps? Soshite, Roboto wa offu desuu.

>x
What do you want to examine?